{
    "tiles": [
        "floor_cobble.png",
        "wall_cobble_down.png",
        "wall_cobble_right.png",
        "wall_cobble_up.png",
        "wall_cobble_left.png",
        "wall_cobble_corner_nw_inner.png",
        "wall_cobble_corner_ne_inner.png",
        "wall_cobble_corner_se_inner.png",
        "wall_cobble_corner_sw_inner.png"
    ],
    "renderLayers": [
        [
            [0, 0, 0, 0, 0, 0, 0, 0],
            [0, 1, 1, 1, 1, 1, 1, 0],
            [0, 1, 1, 1, 1, 1, 1, 0],
            [0, 1, 1, 1, 1, 1, 1, 0],
            [0, 1, 1, 1, 1, 1, 1, 0],
            [0, 1, 1, 1, 1, 1, 1, 0],
            [0, 1, 1, 1, 1, 1, 1, 0],
            [0, 0, 0, 0, 0, 0, 0, 0]
        ],
        [
            [6, 2, 2, 2, 2, 2, 2, 7],
            [3, 0, 0, 0, 0, 0, 0, 5],
            [3, 0, 0, 0, 0, 0, 0, 5],
            [3, 0, 0, 0, 0, 0, 0, 5],
            [3, 0, 0, 0, 0, 0, 0, 5],
            [3, 0, 0, 0, 0, 0, 0, 5],
            [3, 0, 0, 0, 0, 0, 0, 5],
            [9, 4, 4, 4, 4, 4, 4, 8]
        ]
    ],
    "boundaries": [
        [1, 1, 1, 1, 1, 1, 1, 1],
        [1, 0, 0, 0, 0, 0, 0, 1],
        [1, 0, 0, 0, 0, 0, 0, 1],
        [1, 0, 0, 0, 0, 0, 0, 1],
        [1, 0, 0, 0, 0, 0, 0, 1],
        [1, 0, 0, 0, 0, 0, 0, 1],
        [1, 0, 0, 0, 0, 0, 0, 1],
        [1, 1, 1, 1, 1, 1, 1, 1]
    ]
}
